[DebugWorld]
90 90 90 90 90 90 90 90 90 90 90 90 90 90 90 90 90 90 90 90 90 90
90 90 90 90 90 90 90 90 90 90 90 90 90 90 90 90 90 90 90 90 90 90
90 90 90 90 90 90 90 90 90 90 90 90 90 90 90 90 90 90 90 90 90 90
90 90 90 90 90 90 90 90 90 90 90 90 90 90 90 90 90 90 90 90 90 90
90 90 90 90 90 90 90 90 90 90 90 90 90 90 90 90 90 90 90 90 90 90
90 90 90 90 90 90 90 90 90 90 90 90 90 90 90 90 90 90 90 90 90 90
90 90 90 90 90 90 90 90 90 90 90 90 90 90 90 90 90 90 90 90 90 90
90 90 90 90 90 90 90 90 90 90 90 90 90 90 90 90 90 90 90 90 90 90
90 90 90 90 90 90 90 90 90 90 90 90 90 90 90 90 90 90 90 90 90 90
90 90 90 90 90 90 90 90 90 90 90 90 90 90 90 90 90 90 90 90 90 90
90 90 90 90 90 90 90 90 90 90 90 90 90 90 90 90 90 90 90 90 90 90
90 90 90 90 90 90 90 90 90 90 90 90 90 90 90 90 90 90 90 90 90 90
90 90 90 90 90 90 90 90 90 90 90 90 90 90 90 90 90 90 90 90 90 90
90 90 90 90 90 90 90 90 90 90 90 90 90 90 90 90 90 90 90 90 90 90
90 90 90 90 90 90 90 90 90 90 90 90 90 90 90 90 90 90 90 90 90 90
90 90 90 90 90 90 90 90 90 90 90 90 90 90 90 90 90 90 90 90 90 90
90 90 90 90 90 90 90 90 90 90 90 90 90 90 90 90 90 90 90 90 90 90
90 90 90 90 90 90 90 90 90 90 90 90 90 90 90 90 90 90 90 90 90 90
90 90 90 90 90 90 90 90 90 90 90 90 90 90 90 90 90 90 90 90 90 90
90 90 90 90 90 90 90 90 90 90 90 90 90 90 90 90 90 90 90 90 90 90
90 90 90 90 90 90 90 90 90 90 90 90 90 90 90 90 90 90 90 90 90 90
90 90 90 90 90 90 90 90 90 90 90 90 90 90 90 90 90 90 90 90 90 90
MUSIC: 0
TILE: 1, 1, 0
TILE: 2, 1, 1
TILE: 3, 1, 2
TILE: 4, 1, 3
TILE: 5, 1, 4
TILE: 6, 1, 5
TILE: 7, 1, 6
TILE: 8, 1, 7
TILE: 9, 1, 8
TILE: 10, 1, 9
TILE: 11, 1, 10
TILE: 13, 1, 11
TILE: 14, 1, 12
TILE: 15, 1, 12
TILE: 16, 1, 13
TILE: 17, 1, 14
TILE: 18, 1, 15
TILE: 19, 1, 16
TILE: 20, 1, 17
TILE: 1, 4, 18
TILE: 2, 4, 19
TILE: 3, 4, 20
TILE: 4, 4, 21
TILE: 5, 4, 22
TILE: 6, 4, 23
TILE: 7, 4, 24
TILE: 8, 4, 25
TILE: 9, 4, 26
TILE: 10, 4, 27
TILE: 11, 4, 28
TILE: 13, 4, 29
TILE: 14, 4, 30
TILE: 15, 4, 31
TILE: 16, 4, 32
TILE: 17, 4, 33
TILE: 18, 4, 34
TILE: 19, 4, 35
TILE: 20, 4, 36
TILE: 1, 20, 90
TILE: 2, 20, 91
TILE: 3, 20, 92
TILE: 4, 20, 93
TILE: 5, 20, 94
TILE: 6, 20, 95
TILE: 7, 20, 96
TILE: 8, 20, 97
TILE: 9, 20, 98
TILE: 10, 20, 99
TILE: 20, 18, DOOR
TILE: 20, 20, DOOR
TRIGGER: 20,18,SampleWorld,10,20
TRIGGER: 20,20,World1,10,20
SIGN: 10,10,This is the Debug World, you are not supposed to be here.

[SampleWorld]
9 9 9 9 9 9 9 9 9 9 9 9 9 9 9 9 9 9 9 9 9 9
9 9 9 9 9 9 9 9 9 9 9 9 9 9 9 9 9 9 9 9 9 9
9 9 9 9 9 9 9 9 9 9 9 9 9 9 9 9 9 9 9 9 9 9
9 9 9 9 9 9 9 9 9 9 9 9 9 9 9 9 9 9 9 9 9 9
9 9 9 9 9 9 9 9 9 9 9 9 9 9 9 9 9 9 9 9 9 9
9 9 9 9 9 9 9 9 9 9 9 9 9 9 9 9 9 9 9 9 9 9
9 9 9 9 9 9 9 9 9 9 9 9 9 9 9 9 9 9 9 9 9 9
9 9 9 9 9 9 9 9 9 9 9 9 9 9 9 9 9 9 9 9 9 9
8 8 8 8 8 8 8 8 8 8 8 8 8 8 8 8 8 8 8 8 8 8
0 0 0 0 0 0 0 0 0 0 0 0 0 0 0 0 0 0 0 0 0 0
0 0 0 0 0 0 0 0 0 0 0 0 0 0 0 0 0 0 0 0 0 0
0 0 0 0 0 0 0 0 0 0 0 0 0 0 0 0 0 0 0 0 0 0
0 0 0 0 0 0 0 0 0 0 0 0 0 0 0 0 0 0 0 0 0 0
0 0 0 0 0 0 0 0 0 0 0 0 0 0 0 0 0 0 0 0 0 0
0 0 0 0 0 0 0 0 0 0 0 0 0 0 0 0 0 0 0 0 0 0
0 0 0 0 0 0 0 0 0 0 0 0 0 0 0 0 0 0 0 0 0 0
0 0 0 0 0 0 0 0 0 0 0 0 0 0 0 0 0 0 0 0 0 0
0 0 0 0 0 0 0 0 0 0 0 0 0 0 0 0 0 0 0 0 0 0
0 0 0 0 0 0 0 0 0 0 0 0 0 0 0 0 0 0 0 0 0 0
0 0 0 0 0 0 0 0 0 0 0 0 0 0 0 0 0 0 0 0 0 0
0 0 0 0 0 0 0 0 0 0 0 0 0 0 0 0 0 0 0 0 0 0
0 0 0 0 0 0 0 0 0 0 0 0 0 0 0 0 0 0 0 0 0 0
# NPC: x, y, spriteID, Name, Dialogue
MUSIC: 1
NPC: 10, 10, 91, Shirayuki, false, Oh?;What are you doing here;Don't you think you've gone somewhere you weren't supposed to go to?;...;Oh well;It's not like they can hear us here

[House1]
4 4 4 4 4 4 4 4 4 4 4 4 4 4 4 4 4 4 4 4 4 4
4 4 4 4 4 4 4 4 4 4 4 4 4 4 4 4 4 4 4 4 4 4
4 4 4 4 4 4 4 4 4 4 4 4 4 4 4 4 4 4 4 4 4 4
4 4 4 4 4 4 4 4 4 4 4 4 4 4 4 4 4 4 4 4 4 4
4 4 4 4 4 4 4 4 4 4 4 4 4 4 4 4 4 4 4 4 4 4
4 4 4 4 4 4 4 4 4 4 4 4 4 4 4 4 4 4 4 4 4 4
4 4 4 4 4 4 4 4 4 4 4 4 4 4 4 4 4 4 4 4 4 4
4 4 4 4 4 4 4 4 4 4 4 4 4 4 4 4 4 4 4 4 4 4
4 4 4 4 4 4 4 4 4 4 4 4 4 4 4 4 4 4 4 4 4 4
4 4 4 4 4 4 4 4 4 4 4 4 4 4 4 4 4 4 4 4 4 4
4 4 4 4 4 4 4 4 4 4 4 4 4 4 4 4 4 4 4 4 4 4
4 4 4 4 4 4 4 4 4 4 4 4 4 4 4 4 4 4 4 4 4 4
4 4 4 4 4 4 4 4 4 4 4 4 4 4 4 4 4 4 4 4 4 4
4 4 4 4 4 4 4 4 4 4 4 4 4 4 4 4 4 4 4 4 4 4
4 4 4 4 4 4 4 4 4 4 4 4 4 4 4 4 4 4 4 4 4 4
4 4 4 4 4 4 4 4 4 4 4 4 4 4 4 4 4 4 4 4 4 4
4 4 4 4 4 4 4 4 4 4 4 4 4 4 4 4 4 4 4 4 4 4
4 4 4 4 4 4 4 4 4 4 4 4 4 4 4 4 4 4 4 4 4 4
4 4 4 4 4 4 4 4 4 4 4 4 4 4 4 4 4 4 4 4 4 4
4 4 4 4 4 4 4 4 4 4 4 4 4 4 4 4 4 4 4 4 4 4
4 4 4 4 4 4 4 4 4 4 4 4 4 4 4 4 4 4 4 4 4 4
4 4 4 4 4 4 4 4 4 4 4 4 4 4 4 4 4 4 4 4 4 4
MUSIC: 0
TILE: 10, 21, DOOR
TILE: 11, 21, DOOR
TRIGGER: 10,21,World1,15,7
TRIGGER: 11,21,World1,16,7

# 1 2 3 4 5 6 7 8 9 1 2 3 4 5 6 7 8 9 1 2 3
[World1]
1 1 1 1 1 1 1 1 1 1 1 1 1 1 1 1 1 1 1 1 1 1
1 0 0 0 0 0 0 0 0 0 0 0 0 0 0 0 0 0 0 0 0 1
1 0 0 0 0 0 0 0 0 0 0 0 0 0 0 0 0 0 0 0 0 1
1 0 0 0 0 0 0 0 0 0 0 0 0 0 0 0 0 0 0 0 0 1
1 0 0 0 0 0 0 0 0 0 0 0 3 3 3 3 3 3 3 3 0 1
1 0 0 0 0 0 0 0 0 0 0 0 3 2 2 2 2 2 2 3 0 1
1 0 0 0 0 0 0 0 0 0 0 0 3 2 2 0 0 2 2 3 0 1
1 0 0 0 0 0 0 0 0 0 0 0 0 0 0 0 0 0 0 0 0 1
1 0 0 0 0 0 0 0 0 0 0 0 0 0 0 0 0 0 0 0 0 1
1 0 0 0 0 0 0 0 0 0 0 0 0 0 0 0 0 0 0 0 0 1
1 0 0 0 0 0 0 0 0 0 0 0 0 0 0 0 0 0 0 0 0 1
1 0 0 0 0 0 0 0 0 0 0 0 0 0 0 0 0 0 0 0 0 1
1 0 0 0 0 0 0 0 0 0 0 0 0 0 0 0 0 0 0 0 0 1
1 0 0 0 0 0 0 0 0 0 0 0 0 0 0 0 0 0 0 0 0 1
1 0 0 0 0 0 0 0 0 0 0 0 0 0 0 0 0 0 0 0 0 1
1 0 0 0 0 0 0 0 0 0 0 0 0 0 0 0 0 0 0 0 0 1
1 0 0 0 0 0 0 0 0 0 0 0 0 0 0 0 0 0 0 0 0 1
1 0 0 0 0 0 0 0 0 0 0 0 0 0 0 0 0 0 0 0 0 1
1 0 0 0 0 0 0 0 0 0 0 0 0 0 0 0 0 0 0 0 0 1
1 0 0 0 0 0 0 0 0 0 0 0 0 0 0 0 0 0 0 0 0 1
1 0 0 0 0 0 0 0 0 0 0 0 0 0 0 0 0 0 0 0 0 1
1 1 1 1 1 1 1 1 1 1 0 0 1 1 1 1 1 1 1 1 1 1
# TILE: X_COORD, Y_COORD, OBJ_ID_NO or OBJ_NAME
MUSIC: 0
TILE: 5, 5, TREE
TILE: 6, 4, TREE
TILE: 3, 15, TREE
TILE: 7, 10, TREE
TILE: 6, 7, TREE
TILE: 10, 8, COBBLESTONE
TILE: 11, 8, COBBLESTONE
TILE: 10, 9, COBBLESTONE
TILE: 11, 9, COBBLESTONE
TILE: 10, 10, COBBLESTONE
TILE: 11, 10, COBBLESTONE
TILE: 10, 11, COBBLESTONE
TILE: 11, 11, COBBLESTONE
TILE: 10, 12, COBBLESTONE
TILE: 11, 12, COBBLESTONE
TILE: 10, 13, COBBLESTONE
TILE: 11, 13, COBBLESTONE
TILE: 10, 14, COBBLESTONE
TILE: 11, 14, COBBLESTONE
TILE: 10, 15, COBBLESTONE
TILE: 11, 15, COBBLESTONE
TILE: 10, 16, COBBLESTONE
TILE: 11, 16, COBBLESTONE
TILE: 10, 17, COBBLESTONE
TILE: 11, 17, COBBLESTONE
TILE: 10, 18, COBBLESTONE
TILE: 11, 18, COBBLESTONE
TILE: 10, 19, COBBLESTONE
TILE: 11, 19, COBBLESTONE
TILE: 10, 20, COBBLESTONE
TILE: 11, 20, COBBLESTONE
TILE: 11, 3, WOOD_ROOF_LEFT
TILE: 12, 3, WOOD_ROOF
TILE: 13, 3, WOOD_ROOF
TILE: 14, 3, WOOD_ROOF
TILE: 15, 3, WOOD_ROOF
TILE: 16, 3, WOOD_ROOF
TILE: 17, 3, WOOD_ROOF
TILE: 18, 3, WOOD_ROOF
TILE: 19, 3, WOOD_ROOF
TILE: 20, 3, WOOD_ROOF_RIGHT
TILE: 10, 21, DOOR
TILE: 11, 21, DOOR
TILE: 15, 6, DOOR
TILE: 16, 6, DOOR
NPC: 18, 7, 92, Shirayuki, true,Hi!;I'm Shirayuki!;I hope you enjoy your stay here;There's not much right now;But maybe in the future there will be more!
SIGN: 10,5,Welcome to Mogador! Its chilly out right now.
TRIGGER: 10,21,World2,10,1
TRIGGER: 11,21,World2,11,1
TRIGGER: 15,6,House1,10,20
TRIGGER: 16,6,House1,11,20


[World2]
1 1 1 1 1 1 1 1 1 1 0 0 1 1 1 1 1 1 1 1 1 1
1 0 0 1 1 1 1 0 0 0 0 0 0 0 0 0 0 0 0 0 0 1
1 0 0 1 1 1 1 0 0 0 0 0 0 0 0 0 0 0 0 0 0 1
1 0 0 1 1 1 1 0 0 0 0 0 0 0 0 0 0 0 0 0 0 1
1 0 0 0 0 0 0 0 0 0 0 0 0 0 0 0 0 0 0 0 0 1
1 0 0 0 0 0 0 0 0 0 0 0 0 0 0 0 0 0 0 0 0 1
1 0 0 0 0 0 0 0 0 0 0 0 0 0 0 0 0 0 0 0 0 1
1 0 0 0 0 0 0 0 0 0 0 0 0 0 0 0 0 0 0 0 0 1
1 0 0 0 0 0 0 0 0 0 0 0 0 0 0 0 0 0 0 0 0 1
1 0 0 0 0 0 0 0 0 0 0 0 0 0 0 0 0 0 0 0 0 1
1 0 0 0 0 0 0 0 0 0 0 0 0 0 0 0 0 0 0 0 0 1
1 0 0 0 0 0 0 0 0 0 0 0 0 0 0 0 0 0 0 0 0 1
1 0 0 0 0 0 0 0 0 0 0 0 0 0 0 0 0 0 0 0 0 1
1 0 0 0 0 0 0 0 0 0 0 0 0 0 0 0 0 0 0 0 0 1
1 0 0 0 0 0 0 0 0 0 0 0 0 0 0 0 0 0 0 0 0 1
1 0 0 0 0 0 0 0 0 0 0 0 0 0 0 0 0 0 0 0 0 1
1 0 0 0 0 0 0 0 0 0 0 0 0 0 0 0 0 0 0 0 0 1
1 0 0 0 0 0 0 0 0 0 0 0 0 0 0 0 0 0 0 0 0 1
1 0 0 0 0 0 0 0 0 0 0 0 0 0 0 0 0 0 0 0 0 1
1 0 0 0 0 0 0 0 0 0 0 0 0 0 0 0 0 0 0 0 0 1
1 0 0 0 0 0 0 0 0 0 0 0 0 0 0 0 0 0 0 0 0 1
1 1 1 1 1 1 1 1 1 1 1 1 1 1 1 1 1 1 1 1 1 1
# TILE: X_COORD, Y_COORD, OBJ_ID_NO
MUSIC: 0
TILE: 10, 0, 10
TILE: 11, 0, 10
TRIGGER: 10,0,World1,10,20
TRIGGER: 11,0,World1,11,20
SIGN: 5,20,If you hear something, it has probably already heard you.